//MAP CONVERTED BY dmm2tgm.py THIS HEADER COMMENT PREVENTS RECONVERSION, DO NOT REMOVE
"aa" = (
/turf/template_noop,
/area/template_noop)
"ab" = (
/turf/open/floor/plating/asteroid/basalt/lava_land_surface,
/area/lavaland/surface/outdoors/unexplored)
"ac" = (
/obj/structure/fluff/clockwork/alloy_shards/small,
/turf/open/floor/plating/asteroid/basalt/lava_land_surface,
/area/lavaland/surface/outdoors/unexplored)
"ad" = (
/obj/structure/girder/bronze,
/turf/open/floor/plating/asteroid/basalt/lava_land_surface,
/area/lavaland/surface/outdoors/unexplored)
"ae" = (
/obj/item/stack/tile/bronze,
/turf/open/floor/bronze/lavaland,
/area/lavaland/surface/outdoors/unexplored)
"af" = (
/turf/closed/mineral/volcanic/lava_land_surface,
/area/lavaland/surface/outdoors/unexplored)
"ag" = (
/obj/structure/fluff/clockwork/alloy_shards/medium_gearbit,
/turf/open/floor/plating/asteroid/basalt/lava_land_surface,
/area/lavaland/surface/outdoors/unexplored)
"ah" = (
/turf/open/floor/bronze/lavaland,
/area/lavaland/surface/outdoors/unexplored)
"ai" = (
/obj/structure/grille/broken,
/turf/open/floor/plating/asteroid/basalt/lava_land_surface,
/area/lavaland/surface/outdoors/unexplored)
"aj" = (
/turf/closed/wall/mineral/bronze,
/area/lavaland/surface/outdoors/unexplored)
"ak" = (
/obj/structure/fluff/clockwork/alloy_shards/small,
/turf/open/floor/bronze/lavaland,
/area/lavaland/surface/outdoors/unexplored)
"al" = (
/turf/open/lava/smooth/lava_land_surface,
/area/lavaland/surface/outdoors/unexplored)
"am" = (
/obj/structure/fluff/clockwork/alloy_shards/medium,
/turf/open/floor/plating/asteroid/basalt/lava_land_surface,
/area/lavaland/surface/outdoors/unexplored)
"an" = (
/obj/structure/fluff/clockwork/blind_eye,
/turf/open/floor/plating/asteroid/basalt/lava_land_surface,
/area/lavaland/surface/outdoors/unexplored)
"ao" = (
/obj/structure/fluff/clockwork/alloy_shards/large,
/turf/open/floor/plating/asteroid/basalt/lava_land_surface,
/area/lavaland/surface/outdoors/unexplored)
"ap" = (
/obj/structure/fluff/clockwork/alloy_shards/medium,
/turf/open/floor/bronze/lavaland,
/area/lavaland/surface/outdoors/unexplored)
"aq" = (
/obj/structure/lattice,
/turf/open/lava/smooth/lava_land_surface,
/area/lavaland/surface/outdoors/unexplored)
"ar" = (
/obj/structure/lattice,
/turf/open/floor/plating/asteroid/basalt/lava_land_surface,
/area/lavaland/surface/outdoors/unexplored)
"as" = (
/obj/structure/fluff/clockwork/alloy_shards/large,
/turf/open/floor/bronze/lavaland,
/area/lavaland/surface/outdoors/unexplored)
"at" = (
/obj/item/stack/tile/bronze,
/turf/open/floor/plating/asteroid/basalt/lava_land_surface,
/area/lavaland/surface/outdoors/unexplored)
"au" = (
/obj/structure/grille,
/turf/open/floor/bronze/lavaland,
/area/lavaland/surface/outdoors/unexplored)
"av" = (
/obj/structure/fluff/clockwork/alloy_shards/medium,
/obj/structure/lattice,
/turf/open/floor/plating/asteroid/basalt/lava_land_surface,
/area/lavaland/surface/outdoors/unexplored)
"aw" = (
/obj/structure/grille/broken,
/turf/open/floor/bronze/lavaland,
/area/lavaland/surface/outdoors/unexplored)
"ax" = (
/obj/structure/girder/bronze,
/obj/item/stack/tile/bronze,
/turf/open/floor/bronze/lavaland,
/area/lavaland/surface/outdoors/unexplored)
"ay" = (
/obj/structure/fluff/clockwork/fallen_armor,
/turf/open/floor/bronze/lavaland,
/area/lavaland/surface/outdoors/unexplored)
"az" = (
/obj/structure/girder/bronze,
/turf/open/floor/bronze/lavaland,
/area/lavaland/surface/outdoors/unexplored)
"aA" = (
/obj/structure/fluff/clockwork/clockgolem_remains,
/turf/open/floor/bronze/lavaland,
/area/lavaland/surface/outdoors/unexplored)
"aB" = (
/obj/item/nullrod/spear,
/turf/open/floor/bronze/lavaland,
/area/lavaland/surface/outdoors/unexplored)
"aC" = (
/obj/structure/fluff/clockwork/alloy_shards/medium_gearbit,
/turf/open/floor/bronze/lavaland,
/area/lavaland/surface/outdoors/unexplored)
"aD" = (
/obj/structure/grille,
/turf/open/floor/plating/asteroid/basalt/lava_land_surface,
/area/lavaland/surface/outdoors/unexplored)
"aE" = (
/obj/structure/fluff/clockwork/clockgolem_remains,
/turf/open/floor/plating/asteroid/basalt/lava_land_surface,
/area/lavaland/surface/outdoors/unexplored)
"aF" = (
/obj/structure/dead_ratvar,
/turf/open/floor/bronze/lavaland,
/area/lavaland/surface/outdoors/unexplored)
"aG" = (
/obj/item/stack/tile/bronze/thirty,
/turf/open/floor/plating/asteroid/basalt/lava_land_surface,
/area/lavaland/surface/outdoors/unexplored)
"aH" = (
/turf/open/lava/smooth/lava_land_surface,
/area/ruin/unpowered/ratvar)
"aI" = (
/obj/structure/fluff/clockwork/alloy_shards/medium_gearbit,
/turf/open/floor/bronze/filled/lavaland,
/area/ruin/unpowered/ratvar)
"aJ" = (
/obj/structure/fluff/clockwork/alloy_shards/large,
/turf/open/floor/plating/asteroid/basalt/lava_land_surface,
/area/ruin/unpowered/ratvar)
"aK" = (
/obj/structure/grille/broken,
/turf/open/floor/bronze/filled/lavaland,
/area/ruin/unpowered/ratvar)
"aL" = (
/obj/structure/fluff/clockwork/alloy_shards/medium,
/turf/open/floor/plating/asteroid/basalt/lava_land_surface,
/area/ruin/unpowered/ratvar)
"aM" = (
/obj/structure/grille,
/turf/open/floor/plating/asteroid/basalt/lava_land_surface,
/area/ruin/unpowered/ratvar)
"aN" = (
/obj/structure/lattice,
/turf/open/floor/plating/asteroid/basalt/lava_land_surface,
/area/ruin/unpowered/ratvar)
"aO" = (
/turf/open/floor/plating/asteroid/basalt/lava_land_surface,
/area/ruin/unpowered/ratvar)
"aP" = (
/obj/item/stack/sheet/bronze/thirty,
/turf/open/floor/plating/asteroid/basalt/lava_land_surface,
/area/ruin/unpowered/ratvar)
"aQ" = (
/obj/structure/fluff/clockwork/clockgolem_remains,
/turf/open/floor/plating/asteroid/basalt/lava_land_surface,
/area/ruin/unpowered/ratvar)
"aR" = (
/obj/structure/fluff/clockwork/alloy_shards/medium_gearbit,
/turf/open/floor/plating/asteroid/basalt/lava_land_surface,
/area/ruin/unpowered/ratvar)
"aS" = (
/turf/open/floor/bronze/filled/lavaland,
/area/ruin/unpowered/ratvar)
"aT" = (
/turf/closed/wall/mineral/bronze,
/area/ruin/unpowered/ratvar)
"aU" = (
/obj/structure/fluff/clockwork/alloy_shards/large,
/turf/open/floor/bronze/filled/lavaland,
/area/ruin/unpowered/ratvar)
"aV" = (
/obj/structure/fluff/clockwork/alloy_shards/medium,
/turf/open/floor/bronze/filled/lavaland,
/area/ruin/unpowered/ratvar)
"aW" = (
/turf/closed/mineral/volcanic/lava_land_surface,
/area/ruin/unpowered/ratvar)
"aX" = (
/obj/structure/fluff/clockwork/alloy_shards/small,
/turf/open/floor/plating/asteroid/basalt/lava_land_surface,
/area/ruin/unpowered/ratvar)
"aY" = (
/obj/structure/fluff/clockwork/clockgolem_remains,
/turf/open/floor/bronze/filled/lavaland,
/area/ruin/unpowered/ratvar)
"aZ" = (
/obj/structure/girder/bronze,
/obj/item/stack/sheet/bronze,
/turf/open/floor/bronze/filled/lavaland,
/area/ruin/unpowered/ratvar)
"dM" = (
/obj/structure/grille,
/turf/open/floor/bronze/filled/lavaland,
/area/ruin/unpowered/ratvar)
"fM" = (
/obj/structure/girder/bronze,
/turf/open/floor/bronze/filled/lavaland,
/area/ruin/unpowered/ratvar)
"lh" = (
/obj/structure/fluff/clockwork/alloy_shards/small,
/turf/open/floor/bronze/filled/lavaland,
/area/ruin/unpowered/ratvar)
"vZ" = (
/obj/item/stack/sheet/bronze,
/turf/open/floor/plating/asteroid/basalt/lava_land_surface,
/area/ruin/unpowered/ratvar)
"xa" = (
/obj/structure/grille/broken,
/turf/open/floor/plating/asteroid/basalt/lava_land_surface,
/area/ruin/unpowered/ratvar)
"AH" = (
/obj/structure/fluff/clockwork/blind_eye,
/turf/open/floor/plating/asteroid/basalt/lava_land_surface,
/area/ruin/unpowered/ratvar)
"Bx" = (
/obj/structure/fluff/clockwork/alloy_shards/medium,
/obj/structure/lattice,
/turf/open/floor/plating/asteroid/basalt/lava_land_surface,
/area/ruin/unpowered/ratvar)
"DX" = (
/obj/item/nullrod/spear,
/turf/open/floor/bronze/filled/lavaland,
/area/ruin/unpowered/ratvar)
"RB" = (
/obj/structure/lattice,
/turf/open/lava/smooth/lava_land_surface,
/area/ruin/unpowered/ratvar)
"SP" = (
/obj/structure/girder/bronze,
/turf/open/floor/plating/asteroid/basalt/lava_land_surface,
/area/ruin/unpowered/ratvar)
"TN" = (
/obj/structure/fluff/clockwork/fallen_armor,
/turf/open/floor/bronze/filled/lavaland,
/area/ruin/unpowered/ratvar)
"TR" = (
/obj/structure/dead_ratvar,
/turf/open/floor/bronze/filled/lavaland,
/area/ruin/unpowered/ratvar)
"VJ" = (
/obj/item/stack/sheet/bronze,
/turf/open/floor/bronze/filled/lavaland,
/area/ruin/unpowered/ratvar)

(1,1,1) = {"
aa
aa
aa
aa
aa
aa
aa
aa
aa
aa
aa
aa
aa
aO
aU
aS
aO
aa
aa
aa
aa
aa
aa
aa
"}
(2,1,1) = {"
aa
aa
aa
aa
aa
aa
aa
aJ
aO
aa
aS
aO
aN
aX
aT
aZ
aO
aO
aR
aa
aa
aa
aa
aa
"}
(3,1,1) = {"
aa
aa
aa
aa
aa
aa
aW
aO
aH
aO
Bx
aO
aV
aK
aT
aT
aX
aH
aO
aO
aa
aa
aa
aa
"}
(4,1,1) = {"
aa
aa
aa
aa
aa
aa
aW
aH
aH
aN
aO
aO
aH
aT
aT
aT
aV
aH
aO
aS
aX
aN
aa
aa
"}
(5,1,1) = {"
aa
aa
aa
aa
aa
aO
aH
aH
aV
aS
aX
aH
aH
aH
aT
aH
aO
aH
aH
aM
aS
aN
aa
aa
"}
(6,1,1) = {"
aa
aa
aa
aS
aX
aS
aL
aH
aH
aX
aH
aH
aH
aH
aK
aH
aH
aH
aL
aX
aS
aW
aa
aa
"}
(7,1,1) = {"
aa
aa
aO
aO
aO
aH
aH
aH
aH
aS
aO
aH
aH
aH
aH
aH
aH
aH
aH
aX
aW
aW
aO
aa
"}
(8,1,1) = {"
aa
aS
aS
aR
aX
aO
aH
aH
aH
aH
AH
aS
aN
aH
aH
aO
aH
aH
aH
aH
aW
aO
aa
aa
"}
(9,1,1) = {"
aa
aO
aX
aO
aO
aH
aH
aH
aH
vZ
aS
aO
aS
aK
aV
aO
aR
aH
aH
aO
aO
aO
aO
aa
"}
(10,1,1) = {"
aO
aS
aH
aH
aH
aH
aH
aH
aO
aO
aV
aN
TR
aO
aS
aY
aO
aH
aH
aH
aL
aH
aH
aa
"}
(11,1,1) = {"
aX
xa
aT
aT
aH
aH
aH
aH
aH
aO
aS
lh
aS
aS
aS
aN
aH
aH
aH
aH
aH
aH
aO
aa
"}
(12,1,1) = {"
SP
aT
aT
aT
aS
aH
aH
aO
aH
RB
aN
aS
aS
aS
aX
RB
aH
aO
aH
aH
aO
aS
aJ
aa
"}
(13,1,1) = {"
VJ
lh
aO
aH
aH
aH
aO
aV
aU
aN
aS
aS
aS
aS
aS
aS
aS
aH
aH
aH
aH
aO
aO
aa
"}
(14,1,1) = {"
aO
aO
aO
aL
aH
aH
aH
aO
aS
aS
lh
aS
aS
aS
aS
aS
aX
aO
aH
aH
aO
aO
aS
aO
"}
(15,1,1) = {"
aO
aO
aO
aH
aH
aH
aH
aS
aS
aS
aS
aS
aS
aS
lh
DX
aS
aH
aH
aH
aH
aO
aO
aa
"}
(16,1,1) = {"
aW
aH
aH
aH
aH
aH
aH
RB
aO
aS
aS
aS
aS
aS
aS
aU
aO
aH
aH
aH
aH
aW
aW
aa
"}
(17,1,1) = {"
aO
aO
aO
aH
aH
aH
aO
aH
RB
aN
aS
aS
aS
aS
aS
aO
aU
aN
aH
aN
aH
aH
aO
aa
"}
(18,1,1) = {"
aO
aS
aH
aH
aH
aO
aO
aS
aO
aS
aS
aS
aS
aS
aN
lh
aO
aI
aN
aS
aO
aO
aL
aO
"}
(19,1,1) = {"
aO
aO
aH
aH
aH
aH
aS
aO
aS
aS
aS
aS
aS
aS
aS
aN
aT
aS
aX
aS
aN
aS
aO
aO
"}
(20,1,1) = {"
aO
aH
aH
aH
aH
aO
aO
aV
aS
aX
aS
lh
aS
aS
aJ
aO
aH
aH
aH
aO
aQ
aN
aP
aJ
"}
(21,1,1) = {"
aR
aO
aH
aH
aH
aH
aH
aN
aS
aN
aS
aS
aS
aS
TN
aH
aH
aH
aH
aH
aH
aT
aT
aN
"}
(22,1,1) = {"
aX
aX
aO
aH
aH
aO
aS
aS
vZ
aO
aS
aS
aS
aS
aS
aL
aO
aH
aH
aH
aS
aT
aT
aT
"}
(23,1,1) = {"
aO
aS
aL
AH
aO
aS
aH
aJ
aT
dM
aN
aV
aS
aN
aS
aO
aH
aH
aH
aO
aO
aK
aN
aO
"}
(24,1,1) = {"
aa
aa
aO
aO
aH
aH
aH
aT
aT
RB
aV
aS
aL
VJ
fM
aT
aT
aH
aH
aX
aH
aH
aO
aa
"}
(25,1,1) = {"
aa
aa
aO
aH
aH
aH
aH
aT
aH
aH
aO
aS
aN
aZ
aS
aH
aH
aH
aH
aH
aH
aa
aa
aa
"}
(26,1,1) = {"
aa
aa
aO
aX
aO
aH
aH
aH
aH
aH
aH
aR
RB
aO
aS
aH
aH
aH
aX
aL
aO
aa
aa
aa
"}
(27,1,1) = {"
aa
aa
aa
aO
aS
aO
aH
aH
aH
aH
aH
aH
aH
aH
aH
aH
aH
aH
aH
aO
aa
aa
aa
aa
"}
(28,1,1) = {"
aa
aa
aa
aa
aX
aO
aH
aO
aH
aH
aH
aH
aH
aH
aH
aH
aO
aH
aW
aa
aa
aa
aa
aa
"}
(29,1,1) = {"
aa
aa
aa
aa
aO
aO
aW
aX
aO
aH
aX
aH
aH
aH
aH
aX
aJ
aH
aO
aa
aa
aa
aa
aa
"}
(30,1,1) = {"
aa
aa
aa
aa
aa
aR
aX
aO
aH
aH
aO
aL
aH
aO
aH
aW
aO
aa
aa
aa
aa
aa
aa
aa
"}
(31,1,1) = {"
aa
aa
aa
aa
aa
aa
aa
aO
aH
aO
aa
aO
aH
aX
aW
aW
aa
aa
aa
aa
aa
aa
aa
aa
"}
(32,1,1) = {"
aa
aa
aa
aa
aa
aa
aa
aa
aa
aa
aa
aa
aa
aa
aX
aa
aa
aa
aa
aa
aa
aa
aa
aa
"}
