//MAP CONVERTED BY dmm2tgm.py THIS HEADER COMMENT PREVENTS RECONVERSION, DO NOT REMOVE
"aa" = (
/turf/template_noop,
/area/template_noop)
"ab" = (
/obj/structure/lattice,
/turf/template_noop,
/area/template_noop)
"ac" = (
/turf/closed/wall,
/area/ruin/space/has_grav/gasthelizard)
"ad" = (
/obj/machinery/light{
	dir = 1
	},
/obj/structure/bed,
/obj/effect/decal/remains/human,
/obj/effect/turf_decal/stripes/line{
	dir = 8
	},
/turf/open/floor/iron/airless/dark,
/area/ruin/space/has_grav/gasthelizard)
"ae" = (
/obj/structure/window/reinforced{
	dir = 4
	},
/obj/effect/turf_decal/stripes/line{
	dir = 4
	},
/turf/open/floor/iron/airless/dark,
/area/ruin/space/has_grav/gasthelizard)
"af" = (
/obj/structure/window/reinforced{
	dir = 8
	},
/obj/machinery/light{
	dir = 1
	},
/obj/structure/bed,
/obj/effect/decal/remains/human,
/obj/effect/turf_decal/stripes/line{
	dir = 8
	},
/turf/open/floor/iron/airless/dark,
/area/ruin/space/has_grav/gasthelizard)
"ag" = (
/obj/structure/window/reinforced{
	dir = 8
	},
/obj/machinery/light{
	dir = 1
	},
/obj/structure/bed,
/obj/effect/turf_decal/stripes/line{
	dir = 8
	},
/turf/open/floor/iron/airless/dark,
/area/ruin/space/has_grav/gasthelizard)
"ah" = (
/obj/effect/turf_decal/stripes/line{
	dir = 4
	},
/turf/open/floor/iron/airless/dark,
/area/ruin/space/has_grav/gasthelizard)
"ai" = (
/obj/effect/turf_decal/stripes/line{
	dir = 8
	},
/turf/open/floor/iron/airless/dark,
/area/ruin/space/has_grav/gasthelizard)
"aj" = (
/obj/structure/window/reinforced{
	dir = 4
	},
/obj/machinery/atmospherics/components/unary/outlet_injector,
/obj/effect/turf_decal/stripes/line{
	dir = 4
	},
/turf/open/floor/iron/airless/dark,
/area/ruin/space/has_grav/gasthelizard)
"ak" = (
/obj/structure/window/reinforced{
	dir = 8
	},
/obj/effect/turf_decal/stripes/line{
	dir = 8
	},
/turf/open/floor/iron/airless/dark,
/area/ruin/space/has_grav/gasthelizard)
"al" = (
/obj/machinery/atmospherics/components/unary/outlet_injector,
/obj/effect/turf_decal/stripes/line{
	dir = 4
	},
/turf/open/floor/iron/airless/dark,
/area/ruin/space/has_grav/gasthelizard)
"am" = (
/obj/structure/closet/crate/freezer,
/obj/item/stack/sheet/animalhide/lizard,
/obj/item/food/meat/slab/human/mutant/lizard,
/obj/item/food/meat/slab/human/mutant/lizard,
/obj/item/food/meat/slab/human/mutant/lizard,
/obj/item/food/meat/slab/human/mutant/lizard,
/obj/item/food/meat/slab/human/mutant/lizard,
/obj/item/food/meat/slab/human/mutant/lizard,
/turf/open/floor/iron/airless/dark,
/area/ruin/space/has_grav/gasthelizard)
"an" = (
/obj/structure/closet/crate/freezer,
/obj/item/food/meat/slab/human/mutant/lizard,
/obj/item/food/meat/slab/human/mutant/lizard,
/obj/item/food/meat/slab/human/mutant/lizard,
/obj/item/food/meat/slab/human/mutant/lizard,
/obj/item/food/meat/slab/human/mutant/lizard,
/obj/machinery/light{
	dir = 1
	},
/obj/item/food/meat/slab/human/mutant/lizard,
/obj/item/food/meat/slab/human/mutant/lizard,
/turf/open/floor/iron/airless/dark,
/area/ruin/space/has_grav/gasthelizard)
"ao" = (
/obj/structure/closet/crate/freezer,
/obj/item/food/meat/slab/human/mutant/lizard,
/obj/item/food/meat/slab/human/mutant/lizard,
/obj/item/food/meat/slab/human/mutant/lizard,
/obj/item/food/meat/slab/human/mutant/lizard,
/obj/item/clothing/under/rank/prisoner,
/obj/item/food/meat/slab/human/mutant/lizard,
/obj/item/food/meat/slab/human/mutant/lizard,
/obj/item/food/meat/slab/human/mutant/lizard,
/turf/open/floor/iron/airless/dark,
/area/ruin/space/has_grav/gasthelizard)
"ap" = (
/obj/structure/window/reinforced{
	dir = 1;
	layer = 2.9
	},
/obj/effect/turf_decal/tile/blue{
	dir = 1
	},
/obj/effect/turf_decal/tile/blue{
	dir = 4
	},
/turf/open/floor/iron,
/area/ruin/space/has_grav/gasthelizard)
"aq" = (
/obj/machinery/door/window/brigdoor/northleft,
/obj/machinery/atmospherics/components/binary/pump{
	dir = 1
	},
/obj/effect/turf_decal/tile/blue{
	dir = 1
	},
/obj/effect/turf_decal/tile/blue{
	dir = 4
	},
/turf/open/floor/iron,
/area/ruin/space/has_grav/gasthelizard)
"ar" = (
/turf/open/floor/iron/airless/dark,
/area/ruin/space/has_grav/gasthelizard)
"as" = (
/obj/machinery/atmospherics/components/unary/portables_connector/visible{
	dir = 4
	},
/obj/machinery/portable_atmospherics/canister/nitrous_oxide,
/turf/open/floor/iron,
/area/ruin/space/has_grav/gasthelizard)
"at" = (
/obj/machinery/atmospherics/pipe/manifold/general/visible{
	dir = 1
	},
/obj/machinery/power/apc{
	dir = 1;
	name = "Worn-out APC";
	pixel_x = 1;
	pixel_y = 23
	},
/obj/machinery/light{
	dir = 1
	},
/obj/structure/cable,
/turf/open/floor/iron,
/area/ruin/space/has_grav/gasthelizard)
"au" = (
/obj/machinery/atmospherics/pipe/simple/general/visible{
	dir = 4
	},
/turf/open/floor/iron,
/area/ruin/space/has_grav/gasthelizard)
"av" = (
/obj/machinery/atmospherics/pipe/manifold/general/visible,
/turf/open/floor/iron,
/area/ruin/space/has_grav/gasthelizard)
"aw" = (
/obj/machinery/atmospherics/pipe/simple/general/visible{
	dir = 9
	},
/obj/machinery/light{
	dir = 4
	},
/turf/open/floor/iron,
/area/ruin/space/has_grav/gasthelizard)
"ax" = (
/obj/structure/kitchenspike,
/turf/open/floor/iron/airless/dark,
/area/ruin/space/has_grav/gasthelizard)
"ay" = (
/obj/structure/table/reinforced,
/obj/item/kitchen/knife/butcher,
/obj/item/restraints/handcuffs,
/obj/item/reagent_containers/spray/pepper,
/turf/open/floor/iron/airless/dark,
/area/ruin/space/has_grav/gasthelizard)
"az" = (
/obj/machinery/atmospherics/components/unary/portables_connector/visible{
	dir = 4
	},
/obj/machinery/portable_atmospherics/canister/carbon_dioxide,
/turf/open/floor/iron,
/area/ruin/space/has_grav/gasthelizard)
"aA" = (
/obj/machinery/atmospherics/pipe/manifold/general/visible{
	dir = 4
	},
/turf/open/floor/iron,
/area/ruin/space/has_grav/gasthelizard)
"aB" = (
/turf/open/floor/iron,
/area/ruin/space/has_grav/gasthelizard)
"aC" = (
/obj/machinery/gibber,
/turf/open/floor/iron/airless/dark,
/area/ruin/space/has_grav/gasthelizard)
"aD" = (
/obj/structure/table/reinforced,
/obj/item/clothing/suit/straight_jacket,
/obj/item/reagent_containers/syringe/lethal,
/obj/item/reagent_containers/syringe/lethal/choral,
/turf/open/floor/iron/airless/dark,
/area/ruin/space/has_grav/gasthelizard)
"aE" = (
/obj/machinery/atmospherics/components/unary/portables_connector/visible{
	dir = 4
	},
/obj/machinery/portable_atmospherics/canister/toxins,
/turf/open/floor/iron,
/area/ruin/space/has_grav/gasthelizard)
"aF" = (
/obj/machinery/atmospherics/pipe/simple/general/visible{
	dir = 9
	},
/turf/open/floor/iron,
/area/ruin/space/has_grav/gasthelizard)
"aG" = (
/obj/structure/chair/office,
/turf/open/floor/iron,
/area/ruin/space/has_grav/gasthelizard)
"aH" = (
/obj/machinery/door/airlock/security,
/turf/open/floor/iron/airless/dark,
/area/ruin/space/has_grav/gasthelizard)
"aI" = (
/obj/item/reagent_containers/glass/bottle/morphine{
	pixel_x = -4;
	pixel_y = 1
	},
/obj/item/reagent_containers/glass/bottle/chloralhydrate,
/obj/item/reagent_containers/glass/bottle/toxin{
	pixel_x = 6;
	pixel_y = 8
	},
/obj/item/reagent_containers/glass/bottle/morphine{
	pixel_x = 5;
	pixel_y = 1
	},
/obj/item/reagent_containers/glass/bottle/facid{
	name = "fluorosulfuric acid bottle";
	pixel_x = -3;
	pixel_y = 6
	},
/obj/structure/table/reinforced,
/turf/open/floor/iron/airless/dark,
/area/ruin/space/has_grav/gasthelizard)
"aJ" = (
/obj/structure/rack,
/obj/item/storage/toolbox/drone,
/obj/item/melee/baton/cattleprod,
/turf/open/floor/iron,
/area/ruin/space/has_grav/gasthelizard)
"aK" = (
/obj/structure/table,
/obj/item/pen/red,
/turf/open/floor/iron,
/area/ruin/space/has_grav/gasthelizard)
"aL" = (
/obj/structure/table,
/obj/item/paper_bin,
/turf/open/floor/iron,
/area/ruin/space/has_grav/gasthelizard)
"aM" = (
/obj/structure/table,
/obj/item/storage/box/prisoner,
/turf/open/floor/iron,
/area/ruin/space/has_grav/gasthelizard)
"aN" = (
/obj/structure/window/reinforced{
	dir = 4
	},
/obj/machinery/light,
/obj/structure/table,
/obj/item/gps/spaceruin,
/turf/open/floor/iron,
/area/ruin/space/has_grav/gasthelizard)
"aO" = (
/obj/machinery/portable_atmospherics/scrubber,
/obj/effect/turf_decal/bot,
/turf/open/floor/iron,
/area/ruin/space/has_grav/gasthelizard)
"aP" = (
/obj/structure/table/reinforced,
/obj/item/surgicaldrill,
/obj/item/hemostat,
/obj/item/scalpel,
/obj/item/surgical_drapes,
/obj/item/retractor,
/obj/item/cautery,
/obj/item/circular_saw,
/obj/machinery/light,
/turf/open/floor/iron/airless/dark,
/area/ruin/space/has_grav/gasthelizard)
"aQ" = (
/obj/structure/table/optable,
/obj/effect/decal/cleanable/blood/old,
/turf/open/floor/iron/airless/dark,
/area/ruin/space/has_grav/gasthelizard)
"aR" = (
/obj/structure/table/reinforced,
/obj/item/reagent_containers/syringe,
/obj/item/reagent_containers/dropper,
/obj/item/reagent_containers/glass/bottle/mutagen,
/obj/item/reagent_containers/glass/bottle/mutagen,
/obj/item/razor,
/turf/open/floor/iron/airless/dark,
/area/ruin/space/has_grav/gasthelizard)
"aS" = (
/obj/machinery/suit_storage_unit/standard_unit,
/turf/open/floor/iron,
/area/ruin/space/has_grav/gasthelizard)
"aT" = (
/obj/machinery/light,
/turf/open/floor/iron,
/area/ruin/space/has_grav/gasthelizard)
"aU" = (
/obj/structure/closet/emcloset,
/turf/open/floor/iron,
/area/ruin/space/has_grav/gasthelizard)
"aV" = (
/obj/machinery/door/airlock/external,
/obj/effect/mapping_helpers/airlock/cyclelink_helper,
/turf/open/floor/plating,
/area/ruin/space/has_grav/gasthelizard)
"aW" = (
/turf/open/floor/plating,
/area/ruin/space/has_grav/gasthelizard)
"aX" = (
/obj/structure/table/optable,
/obj/effect/decal/cleanable/blood/old,
/turf/open/floor/iron/dark/airless,
/area/ruin/space/has_grav/gasthelizard)
"aY" = (
/obj/structure/table/reinforced,
/obj/item/surgicaldrill,
/obj/item/hemostat,
/obj/item/scalpel,
/obj/item/surgical_drapes,
/obj/item/retractor,
/obj/item/cautery,
/obj/item/circular_saw,
/obj/machinery/light,
/turf/open/floor/iron/dark/airless,
/area/ruin/space/has_grav/gasthelizard)
"aZ" = (
/obj/machinery/door/airlock/external,
/obj/effect/mapping_helpers/airlock/cyclelink_helper{
	dir = 1
	},
/turf/open/floor/plating,
/area/ruin/space/has_grav/gasthelizard)
"bn" = (
/obj/structure/window/reinforced{
	dir = 8
	},
/obj/machinery/light{
	dir = 1
	},
/obj/structure/bed,
/obj/effect/decal/remains/human,
/obj/effect/turf_decal/stripes/line{
	dir = 8
	},
/turf/open/floor/iron/dark/airless,
/area/ruin/space/has_grav/gasthelizard)
"fF" = (
/turf/open/floor/iron/dark/airless,
/area/ruin/space/has_grav/gasthelizard)
"ip" = (
/obj/machinery/light{
	dir = 1
	},
/obj/structure/bed,
/obj/effect/decal/remains/human,
/obj/effect/turf_decal/stripes/line{
	dir = 8
	},
/turf/open/floor/iron/dark/airless,
/area/ruin/space/has_grav/gasthelizard)
"jt" = (
/obj/structure/closet/crate/freezer,
/obj/item/food/meat/slab/human/mutant/lizard,
/obj/item/food/meat/slab/human/mutant/lizard,
/obj/item/food/meat/slab/human/mutant/lizard,
/obj/item/food/meat/slab/human/mutant/lizard,
/obj/item/food/meat/slab/human/mutant/lizard,
/obj/machinery/light{
	dir = 1
	},
/obj/item/food/meat/slab/human/mutant/lizard,
/obj/item/food/meat/slab/human/mutant/lizard,
/turf/open/floor/iron/dark/airless,
/area/ruin/space/has_grav/gasthelizard)
"jX" = (
/obj/machinery/atmospherics/pipe/smart/manifold4w/general/visible{
	dir = 9
	},
/obj/machinery/light{
	dir = 4
	},
/turf/open/floor/iron,
/area/ruin/space/has_grav/gasthelizard)
"rC" = (
/obj/structure/window/reinforced{
	dir = 8
	},
/obj/effect/turf_decal/stripes/line{
	dir = 8
	},
/turf/open/floor/iron/dark/airless,
/area/ruin/space/has_grav/gasthelizard)
"sn" = (
/obj/item/reagent_containers/glass/bottle/morphine{
	pixel_x = -4;
	pixel_y = 1
	},
/obj/item/reagent_containers/glass/bottle/chloralhydrate,
/obj/item/reagent_containers/glass/bottle/toxin{
	pixel_x = 6;
	pixel_y = 8
	},
/obj/item/reagent_containers/glass/bottle/morphine{
	pixel_x = 5;
	pixel_y = 1
	},
/obj/item/reagent_containers/glass/bottle/facid{
	name = "fluorosulfuric acid bottle";
	pixel_x = -3;
	pixel_y = 6
	},
/obj/structure/table/reinforced,
/turf/open/floor/iron/dark/airless,
/area/ruin/space/has_grav/gasthelizard)
"sz" = (
/obj/machinery/atmospherics/components/unary/outlet_injector,
/obj/effect/turf_decal/stripes/line{
	dir = 4
	},
/turf/open/floor/iron/dark/airless,
/area/ruin/space/has_grav/gasthelizard)
"ul" = (
/obj/machinery/atmospherics/pipe/smart/manifold4w/general/visible{
	dir = 4
	},
/turf/open/floor/iron,
/area/ruin/space/has_grav/gasthelizard)
"uN" = (
/obj/structure/window/reinforced{
	dir = 4
	},
/obj/effect/turf_decal/stripes/line{
	dir = 4
	},
/turf/open/floor/iron/dark/airless,
/area/ruin/space/has_grav/gasthelizard)
"vz" = (
/obj/machinery/gibber,
/turf/open/floor/iron/dark/airless,
/area/ruin/space/has_grav/gasthelizard)
"vX" = (
/obj/structure/window/reinforced{
	dir = 8
	},
/obj/machinery/light{
	dir = 1
	},
/obj/structure/bed,
/obj/effect/turf_decal/stripes/line{
	dir = 8
	},
/turf/open/floor/iron/dark/airless,
/area/ruin/space/has_grav/gasthelizard)
"wJ" = (
/obj/effect/turf_decal/stripes/line{
	dir = 4
	},
/turf/open/floor/iron/dark/airless,
/area/ruin/space/has_grav/gasthelizard)
"wT" = (
/obj/structure/kitchenspike,
/turf/open/floor/iron/dark/airless,
/area/ruin/space/has_grav/gasthelizard)
"zA" = (
/obj/machinery/door/airlock/security,
/turf/open/floor/iron/dark/airless,
/area/ruin/space/has_grav/gasthelizard)
"BG" = (
/obj/machinery/atmospherics/pipe/smart/manifold4w/general/visible,
/turf/open/floor/iron,
/area/ruin/space/has_grav/gasthelizard)
"Cc" = (
/obj/machinery/atmospherics/pipe/smart/manifold4w/general/visible{
	dir = 9
	},
/turf/open/floor/iron,
/area/ruin/space/has_grav/gasthelizard)
"Fb" = (
/obj/structure/table/reinforced,
/obj/item/clothing/suit/straight_jacket,
/obj/item/reagent_containers/syringe/lethal,
/obj/item/reagent_containers/syringe/lethal/choral,
/turf/open/floor/iron/dark/airless,
/area/ruin/space/has_grav/gasthelizard)
"Fg" = (
/obj/machinery/atmospherics/pipe/smart/manifold4w/general/visible{
	dir = 1
	},
/obj/machinery/power/apc{
	dir = 1;
	name = "Worn-out APC";
	pixel_x = 1;
	pixel_y = 23
	},
/obj/machinery/light{
	dir = 1
	},
/obj/structure/cable,
/turf/open/floor/iron,
/area/ruin/space/has_grav/gasthelizard)
"Gf" = (
/obj/structure/closet/crate/freezer,
/obj/item/food/meat/slab/human/mutant/lizard,
/obj/item/food/meat/slab/human/mutant/lizard,
/obj/item/food/meat/slab/human/mutant/lizard,
/obj/item/food/meat/slab/human/mutant/lizard,
/obj/item/clothing/under/rank/prisoner,
/obj/item/food/meat/slab/human/mutant/lizard,
/obj/item/food/meat/slab/human/mutant/lizard,
/obj/item/food/meat/slab/human/mutant/lizard,
/turf/open/floor/iron/dark/airless,
/area/ruin/space/has_grav/gasthelizard)
"GE" = (
/obj/effect/turf_decal/stripes/line{
	dir = 8
	},
/turf/open/floor/iron/dark/airless,
/area/ruin/space/has_grav/gasthelizard)
"Pt" = (
/obj/structure/closet/crate/freezer,
/obj/item/stack/sheet/animalhide/lizard,
/obj/item/food/meat/slab/human/mutant/lizard,
/obj/item/food/meat/slab/human/mutant/lizard,
/obj/item/food/meat/slab/human/mutant/lizard,
/obj/item/food/meat/slab/human/mutant/lizard,
/obj/item/food/meat/slab/human/mutant/lizard,
/obj/item/food/meat/slab/human/mutant/lizard,
/turf/open/floor/iron/dark/airless,
/area/ruin/space/has_grav/gasthelizard)
"SR" = (
/obj/structure/table/reinforced,
/obj/item/kitchen/knife/butcher,
/obj/item/restraints/handcuffs,
/obj/item/reagent_containers/spray/pepper,
/turf/open/floor/iron/dark/airless,
/area/ruin/space/has_grav/gasthelizard)
"Xd" = (
/obj/structure/table/reinforced,
/obj/item/reagent_containers/syringe,
/obj/item/reagent_containers/dropper,
/obj/item/reagent_containers/glass/bottle/mutagen,
/obj/item/reagent_containers/glass/bottle/mutagen,
/obj/item/razor,
/turf/open/floor/iron/dark/airless,
/area/ruin/space/has_grav/gasthelizard)
"Zl" = (
/obj/structure/window/reinforced{
	dir = 4
	},
/obj/machinery/atmospherics/components/unary/outlet_injector,
/obj/effect/turf_decal/stripes/line{
	dir = 4
	},
/turf/open/floor/iron/dark/airless,
/area/ruin/space/has_grav/gasthelizard)

(1,1,1) = {"
aa
aa
aa
aa
aa
aa
aa
aa
ab
aa
aa
aa
aa
aa
"}
(2,1,1) = {"
aa
aa
aa
ab
ab
ab
ab
aa
ab
ab
ab
aa
aa
aa
"}
(3,1,1) = {"
aa
aa
aa
ab
ab
ac
ac
ac
ac
ac
ac
ac
ab
aa
"}
(4,1,1) = {"
aa
ab
ab
ab
ab
ac
as
az
aE
aJ
aS
ac
ab
ab
"}
(5,1,1) = {"
ab
aa
ac
ac
ac
ac
Fg
ul
Cc
aB
aT
ac
ac
ac
"}
(6,1,1) = {"
aa
ab
ac
ip
GE
ap
ul
aB
aB
aB
aB
aV
aW
aZ
"}
(7,1,1) = {"
ab
ab
ac
uN
Zl
aq
BG
aB
aB
aB
aU
ac
ac
ac
"}
(8,1,1) = {"
aa
ab
ac
bn
rC
ap
ul
aB
aB
aK
ac
ac
ab
ab
"}
(9,1,1) = {"
ab
ab
ac
uN
Zl
aq
BG
aB
aG
aL
ac
ab
ab
aa
"}
(10,1,1) = {"
aa
aa
ac
vX
rC
ap
ul
aB
aB
aM
ac
ab
aa
aa
"}
(11,1,1) = {"
ab
ab
ac
uN
Zl
aq
BG
aB
aB
aN
ac
ab
aa
aa
"}
(12,1,1) = {"
ab
aa
ac
bn
rC
ap
ul
aB
aB
aO
ac
ab
aa
aa
"}
(13,1,1) = {"
aa
ab
ac
wJ
sz
aq
jX
aB
aB
aO
ac
ab
aa
aa
"}
(14,1,1) = {"
aa
ab
ac
ac
ac
ac
ac
ac
zA
ac
ac
ab
aa
aa
"}
(15,1,1) = {"
aa
ab
ab
ac
Pt
fF
wT
vz
fF
aY
ac
aa
aa
aa
"}
(16,1,1) = {"
aa
ab
ab
ac
jt
fF
fF
fF
fF
aX
ac
aa
aa
aa
"}
(17,1,1) = {"
aa
aa
ab
ac
Gf
fF
SR
Fb
sn
Xd
ac
ab
ab
aa
"}
(18,1,1) = {"
aa
aa
ab
ac
ac
ac
ac
ac
ac
ac
ac
ab
aa
aa
"}
(19,1,1) = {"
aa
aa
aa
aa
ab
ab
aa
aa
ab
ab
ab
aa
aa
aa
"}
