//MAP CONVERTED BY dmm2tgm.py THIS HEADER COMMENT PREVENTS RECONVERSION, DO NOT REMOVE
"ap" = (
/obj/structure/table,
/obj/item/storage/toolbox/mechanical,
/obj/item/multitool,
/obj/effect/decal/cleanable/dirt,
/obj/effect/decal/cleanable/dirt,
/turf/open/floor/iron/airless,
/area/shuttle/caravan/freighter1)
"aL" = (
/obj/item/stack/sheet/mineral/titanium,
/obj/machinery/atmospherics/pipe/smart/manifold4w/supply/hidden{
	dir = 4
	},
/turf/open/floor/iron/airless{
	icon_state = "damaged1"
	},
/area/shuttle/caravan/freighter1)
"bn" = (
/obj/effect/decal/cleanable/dirt,
/obj/machinery/atmospherics/pipe/smart/manifold4w/supply/hidden{
	dir = 4
	},
/turf/open/floor/iron/airless,
/area/shuttle/caravan/freighter1)
"bp" = (
/obj/structure/table,
/obj/item/storage/box/donkpockets{
	pixel_x = 6;
	pixel_y = 6
	},
/obj/item/plate{
	pixel_x = -5;
	pixel_y = -3
	},
/obj/effect/decal/cleanable/dirt,
/obj/effect/turf_decal/tile/neutral{
	dir = 1
	},
/obj/effect/turf_decal/tile/neutral,
/obj/effect/turf_decal/tile/neutral{
	dir = 4
	},
/obj/effect/turf_decal/tile/neutral{
	dir = 8
	},
/turf/open/floor/iron/dark/airless,
/area/shuttle/caravan/freighter1)
"bw" = (
/obj/effect/decal/cleanable/dirt,
/obj/machinery/atmospherics/pipe/smart/manifold4w/supply/hidden,
/turf/open/floor/plating/airless,
/area/shuttle/caravan/freighter1)
"bR" = (
/obj/structure/toilet{
	dir = 4
	},
/obj/structure/sink{
	pixel_y = 24
	},
/obj/machinery/light/small,
/obj/effect/decal/cleanable/dirt,
/obj/effect/decal/cleanable/dirt,
/turf/open/floor/iron/showroomfloor{
	initial_gas_mix = "TEMP=2.7"
	},
/area/shuttle/caravan/freighter1)
"cR" = (
/obj/structure/closet/crate,
/obj/item/stack/sheet/mineral/silver{
	amount = 25
	},
/obj/item/stack/sheet/mineral/silver{
	amount = 25
	},
/turf/open/floor/iron/dark/airless,
/area/shuttle/caravan/freighter1)
"cX" = (
/obj/structure/chair/stool,
/obj/effect/turf_decal/tile/yellow,
/obj/effect/turf_decal/tile/yellow{
	dir = 4
	},
/turf/open/floor/iron{
	initial_gas_mix = "TEMP=2.7"
	},
/area/shuttle/caravan/freighter1)
"dg" = (
/obj/effect/turf_decal/box/white/corners{
	dir = 8
	},
/turf/open/floor/iron/dark/airless,
/area/shuttle/caravan/freighter1)
"dm" = (
/obj/machinery/atmospherics/pipe/smart/manifold4w/supply/hidden{
	dir = 4
	},
/turf/open/floor/iron/airless{
	icon_state = "floorscorched1"
	},
/area/shuttle/caravan/freighter1)
"dq" = (
/obj/effect/turf_decal/box/white/corners,
/obj/structure/closet/crate,
/obj/item/stack/sheet/glass/fifty,
/obj/item/stack/sheet/glass/fifty,
/obj/effect/decal/cleanable/dirt,
/turf/open/floor/iron/dark/airless,
/area/shuttle/caravan/freighter1)
"dx" = (
/obj/machinery/airalarm/all_access{
	pixel_y = 24
	},
/obj/machinery/atmospherics/pipe/smart/manifold4w/supply/hidden{
	dir = 1
	},
/turf/open/floor/iron/airless,
/area/shuttle/caravan/freighter1)
"eo" = (
/obj/machinery/door/firedoor,
/obj/machinery/atmospherics/pipe/smart/manifold4w/supply/hidden{
	dir = 4
	},
/obj/machinery/door/airlock/command{
	name = "Bridge"
	},
/turf/open/floor/iron/dark/airless,
/area/shuttle/caravan/freighter1)
"ey" = (
/obj/structure/closet/crate{
	icon_state = "crateopen"
	},
/obj/item/stack/sheet/iron/fifty,
/turf/open/floor/iron/dark/airless,
/area/shuttle/caravan/freighter1)
"eP" = (
/obj/machinery/door/poddoor{
	id = "caravantrade1_cargo";
	name = "Cargo Blast Door"
	},
/obj/effect/decal/cleanable/dirt,
/turf/open/floor/plating/airless,
/area/shuttle/caravan/freighter1)
"eX" = (
/obj/machinery/light/small{
	dir = 4
	},
/obj/machinery/power/apc{
	dir = 4;
	name = "Small Freighter APC";
	pixel_x = 24;
	start_charge = 0
	},
/obj/effect/decal/cleanable/dirt,
/obj/machinery/atmospherics/pipe/smart/manifold4w/supply/hidden,
/obj/structure/cable,
/turf/open/floor/plating/airless,
/area/shuttle/caravan/freighter1)
"fD" = (
/turf/template_noop,
/area/shuttle/caravan/freighter1)
"gs" = (
/obj/structure/closet/secure_closet/freezer{
	locked = 0;
	name = "fridge"
	},
/obj/item/reagent_containers/food/drinks/beer{
	pixel_x = -3;
	pixel_y = 3
	},
/obj/item/reagent_containers/food/drinks/beer,
/obj/item/reagent_containers/food/drinks/beer{
	pixel_x = 3;
	pixel_y = -3
	},
/obj/item/reagent_containers/food/drinks/waterbottle{
	pixel_x = -3;
	pixel_y = 3
	},
/obj/item/reagent_containers/food/drinks/waterbottle,
/obj/item/reagent_containers/food/drinks/waterbottle{
	pixel_x = 3;
	pixel_y = -3
	},
/obj/item/food/pizzaslice/margherita{
	pixel_x = -3;
	pixel_y = 3
	},
/obj/item/food/pizzaslice/margherita,
/obj/item/food/chocolatebar,
/obj/effect/turf_decal/tile/yellow{
	dir = 1
	},
/obj/effect/turf_decal/tile/yellow,
/obj/effect/turf_decal/tile/yellow{
	dir = 4
	},
/turf/open/floor/iron{
	initial_gas_mix = "TEMP=2.7"
	},
/area/shuttle/caravan/freighter1)
"gw" = (
/obj/structure/chair/comfy/shuttle{
	dir = 4
	},
/obj/effect/decal/cleanable/dirt,
/obj/effect/mob_spawn/human/corpse/cargo_tech,
/obj/effect/decal/cleanable/blood,
/obj/effect/turf_decal/tile/blue,
/turf/open/floor/iron/dark{
	initial_gas_mix = "TEMP=2.7"
	},
/area/shuttle/caravan/freighter1)
"gR" = (
/obj/machinery/airalarm/all_access{
	dir = 4;
	pixel_x = -24
	},
/obj/effect/decal/cleanable/dirt,
/obj/effect/decal/cleanable/blood,
/obj/machinery/atmospherics/components/unary/vent_pump/on,
/turf/open/floor/iron/dark/airless,
/area/shuttle/caravan/freighter1)
"hd" = (
/obj/machinery/firealarm{
	pixel_y = 24
	},
/obj/machinery/atmospherics/pipe/smart/manifold4w/supply/hidden{
	dir = 1
	},
/turf/open/floor/iron/airless,
/area/shuttle/caravan/freighter1)
"hy" = (
/obj/effect/decal/cleanable/dirt,
/obj/machinery/atmospherics/pipe/smart/manifold4w/supply/hidden{
	dir = 8
	},
/obj/effect/decal/cleanable/dirt,
/turf/open/floor/iron/airless,
/area/shuttle/caravan/freighter1)
"jg" = (
/obj/machinery/door/airlock{
	name = "Restroom"
	},
/obj/effect/decal/cleanable/dirt,
/turf/open/floor/iron/showroomfloor{
	initial_gas_mix = "TEMP=2.7"
	},
/area/shuttle/caravan/freighter1)
"jr" = (
/obj/effect/decal/cleanable/dirt,
/obj/machinery/atmospherics/pipe/smart/manifold4w/supply/hidden{
	dir = 1
	},
/turf/open/floor/plating/airless,
/area/shuttle/caravan/freighter1)
"jS" = (
/obj/effect/turf_decal/box/white/corners{
	dir = 4
	},
/obj/effect/decal/cleanable/dirt,
/obj/structure/closet/crate,
/obj/item/stack/sheet/mineral/gold{
	amount = 25
	},
/turf/open/floor/iron/dark/airless,
/area/shuttle/caravan/freighter1)
"kB" = (
/obj/machinery/door/airlock{
	name = "Crew Cabins"
	},
/obj/effect/decal/cleanable/dirt,
/obj/machinery/atmospherics/pipe/smart/manifold4w/supply/hidden{
	dir = 4
	},
/obj/effect/decal/cleanable/dirt,
/turf/open/floor/iron/airless,
/area/shuttle/caravan/freighter1)
"kO" = (
/obj/effect/turf_decal/box/white/corners{
	dir = 1
	},
/obj/structure/closet/crate,
/obj/item/stack/sheet/rglass{
	amount = 20
	},
/obj/item/stack/sheet/rglass{
	amount = 20
	},
/turf/open/floor/iron/dark/airless,
/area/shuttle/caravan/freighter1)
"lt" = (
/obj/structure/closet/crate,
/obj/item/stack/sheet/iron/twenty,
/obj/item/stack/sheet/glass{
	amount = 10
	},
/obj/item/stack/rods/ten,
/obj/item/storage/box/lights/bulbs,
/obj/effect/decal/cleanable/dirt,
/obj/effect/turf_decal/stripes/line{
	dir = 6
	},
/turf/open/floor/plating/airless,
/area/shuttle/caravan/freighter1)
"lx" = (
/obj/effect/turf_decal/box/white/corners{
	dir = 1
	},
/turf/open/floor/iron/airless{
	icon_state = "damaged4"
	},
/area/shuttle/caravan/freighter1)
"lC" = (
/obj/machinery/power/port_gen/pacman{
	anchored = 1
	},
/obj/item/wrench,
/obj/machinery/power/terminal,
/obj/effect/turf_decal/stripes/line{
	dir = 5
	},
/obj/effect/decal/cleanable/dirt,
/obj/structure/cable,
/turf/open/floor/plating/airless,
/area/shuttle/caravan/freighter1)
"lM" = (
/obj/machinery/light/small{
	dir = 8
	},
/obj/structure/sign/warning/vacuum{
	pixel_x = 32
	},
/turf/open/floor/plating,
/area/shuttle/caravan/freighter1)
"mi" = (
/obj/effect/decal/cleanable/dirt,
/obj/machinery/atmospherics/pipe/smart/manifold4w/supply/hidden,
/obj/effect/turf_decal/tile/blue,
/obj/effect/turf_decal/tile/blue{
	dir = 4
	},
/turf/open/floor/iron{
	initial_gas_mix = "TEMP=2.7"
	},
/area/shuttle/caravan/freighter1)
"mo" = (
/obj/structure/shuttle/engine/heater{
	dir = 8
	},
/obj/structure/window/reinforced{
	dir = 4
	},
/turf/open/floor/plating/airless,
/area/shuttle/caravan/freighter1)
"mw" = (
/obj/machinery/light/small{
	dir = 8
	},
/obj/machinery/firealarm{
	dir = 8;
	pixel_x = -24
	},
/obj/effect/decal/cleanable/dirt,
/obj/structure/rack,
/obj/item/storage/toolbox/emergency,
/obj/item/wrench,
/obj/effect/turf_decal/tile/blue{
	dir = 1
	},
/obj/effect/turf_decal/tile/blue{
	dir = 4
	},
/obj/effect/turf_decal/tile/blue{
	dir = 8
	},
/turf/open/floor/iron/dark{
	initial_gas_mix = "TEMP=2.7"
	},
/area/shuttle/caravan/freighter1)
"mZ" = (
/obj/effect/decal/cleanable/dirt,
/obj/machinery/computer/camera_advanced/shuttle_docker/caravan/trade1{
	dir = 8
	},
/obj/effect/turf_decal/tile/blue{
	dir = 1
	},
/obj/effect/turf_decal/tile/blue{
	dir = 4
	},
/obj/effect/turf_decal/tile/blue{
	dir = 8
	},
/turf/open/floor/iron/dark{
	initial_gas_mix = "TEMP=2.7"
	},
/area/shuttle/caravan/freighter1)
"nf" = (
/obj/machinery/atmospherics/pipe/smart/manifold4w/supply/hidden{
	dir = 10
	},
/obj/effect/decal/cleanable/dirt,
/turf/open/floor/iron/airless,
/area/shuttle/caravan/freighter1)
"sf" = (
/obj/machinery/light{
	dir = 1
	},
/obj/structure/table,
/obj/item/stack/package_wrap,
/obj/item/crowbar,
/obj/item/flashlight{
	pixel_x = 1;
	pixel_y = 5
	},
/obj/machinery/airalarm/all_access{
	pixel_y = 24
	},
/obj/effect/decal/cleanable/dirt,
/turf/open/floor/iron/airless,
/area/shuttle/caravan/freighter1)
"si" = (
/obj/effect/mapping_helpers/airlock/cyclelink_helper{
	dir = 1
	},
/obj/effect/mapping_helpers/airlock/locked,
/obj/machinery/door/airlock/external{
	id_tag = "caravantrade1_bolt"
	},
/turf/open/floor/plating,
/area/shuttle/caravan/freighter1)
"ss" = (
/obj/structure/rack,
/obj/item/storage/belt/utility,
/obj/structure/extinguisher_cabinet{
	pixel_y = 29
	},
/obj/effect/decal/cleanable/dirt,
/obj/effect/decal/cleanable/dirt,
/turf/open/floor/iron/airless,
/area/shuttle/caravan/freighter1)
"uh" = (
/obj/effect/decal/cleanable/dirt,
/turf/open/floor/iron/dark/airless,
/area/shuttle/caravan/freighter1)
"ur" = (
/obj/effect/decal/cleanable/dirt,
/turf/open/floor/plating/airless{
	icon_state = "platingdmg3"
	},
/area/shuttle/caravan/freighter1)
"uA" = (
/obj/machinery/light/small,
/obj/structure/bed,
/obj/item/bedsheet,
/obj/effect/decal/cleanable/dirt,
/obj/machinery/airalarm/all_access{
	dir = 8;
	pixel_x = 24
	},
/obj/machinery/button/door{
	id = "caravantrade1_cabin1";
	name = "Cabin Bolt Control";
	normaldoorcontrol = 1;
	pixel_x = -25;
	pixel_y = 6;
	specialfunctions = 4
	},
/obj/machinery/atmospherics/components/unary/vent_pump/on{
	dir = 1
	},
/obj/effect/turf_decal/tile/neutral{
	dir = 1
	},
/obj/effect/turf_decal/tile/neutral,
/obj/effect/turf_decal/tile/neutral{
	dir = 4
	},
/obj/effect/turf_decal/tile/neutral{
	dir = 8
	},
/turf/open/floor/iron/dark/airless,
/area/shuttle/caravan/freighter1)
"uS" = (
/obj/effect/turf_decal/tile/neutral{
	dir = 1
	},
/obj/effect/turf_decal/tile/neutral,
/obj/effect/turf_decal/tile/neutral{
	dir = 4
	},
/obj/effect/turf_decal/tile/neutral{
	dir = 8
	},
/mob/living/simple_animal/hostile/syndicate/ranged/smg/space,
/turf/open/floor/iron/dark/airless,
/area/shuttle/caravan/freighter1)
"vt" = (
/obj/structure/shuttle/engine/propulsion/burst{
	dir = 8
	},
/turf/open/floor/plating/airless,
/area/shuttle/caravan/freighter1)
"xm" = (
/obj/machinery/airalarm/all_access{
	dir = 4;
	pixel_x = -24
	},
/obj/effect/decal/cleanable/dirt,
/obj/machinery/atmospherics/pipe/smart/manifold4w/supply/hidden,
/obj/effect/mob_spawn/human/corpse/cargo_tech,
/obj/effect/decal/cleanable/blood,
/obj/effect/decal/cleanable/dirt,
/turf/open/floor/iron/airless,
/area/shuttle/caravan/freighter1)
"xz" = (
/obj/effect/turf_decal/box/white/corners{
	dir = 4
	},
/turf/open/floor/iron/airless{
	icon_state = "damaged5"
	},
/area/shuttle/caravan/freighter1)
"yn" = (
/obj/structure/closet/crate,
/obj/item/stack/sheet/mineral/titanium{
	amount = 20
	},
/obj/item/stack/sheet/mineral/titanium{
	amount = 20
	},
/obj/effect/turf_decal/tile/neutral{
	dir = 1
	},
/obj/effect/turf_decal/tile/neutral,
/obj/effect/turf_decal/tile/neutral{
	dir = 4
	},
/obj/effect/turf_decal/tile/neutral{
	dir = 8
	},
/turf/open/floor/iron/dark/airless,
/area/shuttle/caravan/freighter1)
"yC" = (
/obj/machinery/button/door{
	id = "caravantrade1_bolt";
	name = "External Bolt Control";
	normaldoorcontrol = 1;
	pixel_x = -25;
	pixel_y = 8;
	specialfunctions = 4
	},
/obj/machinery/atmospherics/components/unary/vent_pump/on,
/obj/effect/turf_decal/tile/blue,
/turf/open/floor/iron{
	initial_gas_mix = "TEMP=2.7"
	},
/area/shuttle/caravan/freighter1)
"yO" = (
/obj/machinery/door/airlock{
	name = "Crew Quarters"
	},
/obj/machinery/atmospherics/pipe/smart/manifold4w/supply/hidden{
	dir = 4
	},
/obj/effect/decal/cleanable/dirt,
/turf/open/floor/iron/airless,
/area/shuttle/caravan/freighter1)
"yY" = (
/obj/machinery/light/small,
/obj/effect/decal/cleanable/dirt,
/obj/machinery/atmospherics/pipe/smart/manifold4w/supply/hidden{
	dir = 4
	},
/obj/effect/turf_decal/tile/yellow{
	dir = 1
	},
/obj/effect/turf_decal/tile/yellow{
	dir = 4
	},
/turf/open/floor/iron{
	initial_gas_mix = "TEMP=2.7"
	},
/area/shuttle/caravan/freighter1)
"zd" = (
/obj/effect/turf_decal/bot,
/obj/machinery/atmospherics/components/unary/tank/air{
	dir = 4
	},
/obj/effect/decal/cleanable/dirt,
/turf/open/floor/plating/airless,
/area/shuttle/caravan/freighter1)
"zy" = (
/obj/structure/girder,
/turf/open/floor/plating/airless{
	icon_state = "platingdmg1"
	},
/area/shuttle/caravan/freighter1)
"Ax" = (
/obj/item/stack/sheet/iron/fifty,
/turf/open/floor/iron/airless{
	icon_state = "floorscorched2"
	},
/area/shuttle/caravan/freighter1)
"CR" = (
/obj/effect/turf_decal/bot_white,
/obj/effect/decal/cleanable/dirt,
/obj/machinery/atmospherics/components/unary/vent_pump/on{
	dir = 1
	},
/obj/effect/turf_decal/tile/neutral{
	dir = 1
	},
/obj/effect/turf_decal/tile/neutral,
/obj/effect/turf_decal/tile/neutral{
	dir = 4
	},
/obj/effect/turf_decal/tile/neutral{
	dir = 8
	},
/turf/open/floor/iron/dark/airless,
/area/shuttle/caravan/freighter1)
"CS" = (
/obj/machinery/atmospherics/pipe/smart/manifold4w/supply/hidden{
	dir = 9
	},
/turf/open/floor/iron/dark/airless,
/area/shuttle/caravan/freighter1)
"Dm" = (
/obj/machinery/atmospherics/pipe/smart/manifold4w/supply/hidden{
	dir = 4
	},
/obj/effect/turf_decal/tile/yellow{
	dir = 4
	},
/turf/open/floor/iron{
	initial_gas_mix = "TEMP=2.7"
	},
/area/shuttle/caravan/freighter1)
"El" = (
/turf/closed/wall/mineral/titanium/nodiagonal,
/area/shuttle/caravan/freighter1)
"Eo" = (
/obj/structure/lattice,
/obj/item/stack/sheet/mineral/titanium,
/turf/template_noop,
/area/shuttle/caravan/freighter1)
"Er" = (
/obj/machinery/light/small,
/obj/effect/turf_decal/box/white/corners,
/obj/machinery/button/door{
	id = "caravantrade1_cargo";
	name = "Cargo Blast Door Control";
	pixel_y = -24
	},
/obj/structure/closet/crate,
/obj/item/stack/sheet/mineral/diamond{
	amount = 5
	},
/turf/open/floor/iron/dark/airless,
/area/shuttle/caravan/freighter1)
"EI" = (
/obj/effect/decal/cleanable/blood,
/obj/effect/turf_decal/tile/blue{
	dir = 4
	},
/mob/living/simple_animal/hostile/syndicate/melee/sword/space/stormtrooper,
/turf/open/floor/iron/dark{
	initial_gas_mix = "TEMP=2.7"
	},
/area/shuttle/caravan/freighter1)
"EQ" = (
/obj/machinery/light/small{
	dir = 4
	},
/obj/machinery/firealarm{
	dir = 4;
	pixel_x = 24
	},
/obj/effect/decal/cleanable/blood,
/obj/machinery/atmospherics/components/unary/vent_pump/on{
	dir = 8
	},
/obj/effect/turf_decal/tile/yellow{
	dir = 4
	},
/mob/living/simple_animal/hostile/syndicate/ranged/smg/space,
/turf/open/floor/iron{
	initial_gas_mix = "TEMP=2.7"
	},
/area/shuttle/caravan/freighter1)
"EW" = (
/obj/structure/table/reinforced,
/obj/machinery/button/door{
	id = "caravantrade1_bridge";
	name = "Ship Blast Door Control"
	},
/obj/effect/turf_decal/tile/blue{
	dir = 1
	},
/obj/effect/turf_decal/tile/blue,
/obj/effect/turf_decal/tile/blue{
	dir = 4
	},
/turf/open/floor/iron/dark{
	initial_gas_mix = "TEMP=2.7"
	},
/area/shuttle/caravan/freighter1)
"EX" = (
/obj/machinery/atmospherics/pipe/smart/manifold4w/supply/hidden{
	dir = 8
	},
/obj/effect/decal/cleanable/dirt,
/turf/open/floor/iron/airless,
/area/shuttle/caravan/freighter1)
"EZ" = (
/obj/effect/turf_decal/tile/neutral{
	dir = 1
	},
/obj/effect/turf_decal/tile/neutral,
/obj/effect/turf_decal/tile/neutral{
	dir = 4
	},
/obj/effect/turf_decal/tile/neutral{
	dir = 8
	},
/turf/open/floor/iron/dark/airless,
/area/shuttle/caravan/freighter1)
"Fv" = (
/turf/closed/wall/mineral/titanium,
/area/shuttle/caravan/freighter1)
"Fx" = (
/obj/structure/lattice,
/obj/structure/fluff/broken_flooring{
	icon_state = "singular"
	},
/turf/template_noop,
/area/shuttle/caravan/freighter1)
"GM" = (
/obj/machinery/door/airlock{
	id_tag = "caravantrade1_cabin1";
	name = "Cabin 1"
	},
/obj/effect/decal/cleanable/dirt,
/obj/machinery/atmospherics/pipe/smart/manifold4w/supply/hidden,
/obj/effect/turf_decal/tile/neutral{
	dir = 1
	},
/obj/effect/turf_decal/tile/neutral,
/obj/effect/turf_decal/tile/neutral{
	dir = 4
	},
/obj/effect/turf_decal/tile/neutral{
	dir = 8
	},
/turf/open/floor/iron/dark/airless,
/area/shuttle/caravan/freighter1)
"Io" = (
/turf/open/floor/iron/dark/airless,
/area/shuttle/caravan/freighter1)
"Ja" = (
/obj/machinery/light/small{
	dir = 8
	},
/obj/effect/decal/cleanable/dirt,
/obj/structure/rack,
/obj/item/storage/firstaid/regular,
/obj/effect/turf_decal/tile/blue{
	dir = 1
	},
/obj/effect/turf_decal/tile/blue,
/obj/effect/turf_decal/tile/blue{
	dir = 8
	},
/turf/open/floor/iron/dark{
	initial_gas_mix = "TEMP=2.7"
	},
/area/shuttle/caravan/freighter1)
"Jb" = (
/obj/machinery/light/small,
/obj/effect/decal/cleanable/dirt,
/obj/machinery/atmospherics/pipe/smart/manifold4w/supply/hidden{
	dir = 4
	},
/turf/open/floor/iron/airless,
/area/shuttle/caravan/freighter1)
"Jv" = (
/turf/template_noop,
/area/template_noop)
"Kc" = (
/obj/machinery/door/airlock{
	id_tag = "caravantrade1_cabin2";
	name = "Cabin 2"
	},
/obj/machinery/atmospherics/pipe/smart/manifold4w/supply/hidden,
/obj/effect/turf_decal/tile/neutral{
	dir = 1
	},
/obj/effect/turf_decal/tile/neutral,
/obj/effect/turf_decal/tile/neutral{
	dir = 4
	},
/obj/effect/turf_decal/tile/neutral{
	dir = 8
	},
/turf/open/floor/iron/dark/airless,
/area/shuttle/caravan/freighter1)
"Ke" = (
/obj/machinery/atmospherics/pipe/smart/manifold4w/supply/hidden{
	dir = 8
	},
/turf/open/floor/iron/airless,
/area/shuttle/caravan/freighter1)
"Ko" = (
/obj/structure/rack,
/obj/item/tank/internals/oxygen,
/obj/item/radio,
/obj/item/clothing/mask/gas,
/obj/effect/turf_decal/tile/blue{
	dir = 4
	},
/turf/open/floor/iron{
	initial_gas_mix = "TEMP=2.7"
	},
/area/shuttle/caravan/freighter1)
"KC" = (
/obj/structure/shuttle/engine/propulsion/burst/right{
	dir = 8
	},
/turf/open/floor/plating/airless,
/area/shuttle/caravan/freighter1)
"KX" = (
/obj/structure/shuttle/engine/propulsion/burst/left{
	dir = 8
	},
/turf/open/floor/plating/airless,
/area/shuttle/caravan/freighter1)
"LC" = (
/obj/effect/decal/cleanable/dirt,
/obj/machinery/atmospherics/pipe/smart/manifold4w/supply/hidden{
	dir = 4
	},
/obj/effect/decal/cleanable/dirt,
/turf/open/floor/iron/airless,
/area/shuttle/caravan/freighter1)
"LK" = (
/obj/machinery/suit_storage_unit/standard_unit,
/obj/effect/decal/cleanable/dirt,
/turf/open/floor/iron/airless,
/area/shuttle/caravan/freighter1)
"LM" = (
/obj/effect/spawner/structure/window/shuttle,
/obj/machinery/door/poddoor{
	id = "caravantrade1_bridge"
	},
/turf/open/floor/plating,
/area/shuttle/caravan/freighter1)
"Ns" = (
/obj/effect/turf_decal/box/white/corners{
	dir = 8
	},
/obj/effect/decal/cleanable/dirt,
/turf/open/floor/iron/dark/airless,
/area/shuttle/caravan/freighter1)
"NE" = (
/obj/machinery/light/small{
	dir = 1
	},
/obj/machinery/airalarm/all_access{
	pixel_y = 24
	},
/obj/machinery/atmospherics/pipe/smart/manifold4w/supply/hidden{
	dir = 4
	},
/turf/open/floor/iron/airless,
/area/shuttle/caravan/freighter1)
"NL" = (
/obj/structure/table,
/obj/machinery/microwave{
	pixel_y = 5
	},
/obj/effect/turf_decal/tile/neutral{
	dir = 1
	},
/obj/effect/turf_decal/tile/neutral,
/obj/effect/turf_decal/tile/neutral{
	dir = 4
	},
/obj/effect/turf_decal/tile/neutral{
	dir = 8
	},
/turf/open/floor/iron/dark/airless,
/area/shuttle/caravan/freighter1)
"NY" = (
/obj/machinery/door/poddoor{
	id = "caravantrade1_cargo";
	name = "Cargo Blast Door"
	},
/obj/effect/decal/cleanable/dirt,
/turf/open/floor/plating/airless{
	icon_state = "platingdmg3"
	},
/area/shuttle/caravan/freighter1)
"Od" = (
/obj/effect/decal/cleanable/dirt,
/obj/structure/table/reinforced,
/obj/item/paper_bin{
	pixel_x = 6;
	pixel_y = 6
	},
/obj/item/pen{
	pixel_x = 6;
	pixel_y = 6
	},
/obj/item/folder/yellow{
	pixel_x = -6
	},
/obj/effect/turf_decal/tile/blue,
/obj/effect/turf_decal/tile/blue{
	dir = 4
	},
/obj/effect/turf_decal/tile/blue{
	dir = 8
	},
/turf/open/floor/iron/dark{
	initial_gas_mix = "TEMP=2.7"
	},
/area/shuttle/caravan/freighter1)
"Ol" = (
/obj/effect/decal/cleanable/dirt,
/obj/machinery/atmospherics/pipe/smart/manifold4w/supply/hidden{
	dir = 10
	},
/obj/effect/decal/cleanable/blood,
/obj/effect/turf_decal/tile/yellow{
	dir = 1
	},
/obj/effect/turf_decal/tile/yellow{
	dir = 4
	},
/turf/open/floor/iron{
	initial_gas_mix = "TEMP=2.7"
	},
/area/shuttle/caravan/freighter1)
"Ov" = (
/obj/effect/decal/cleanable/dirt,
/turf/open/floor/iron/airless{
	icon_state = "damaged2"
	},
/area/shuttle/caravan/freighter1)
"Ow" = (
/obj/effect/decal/cleanable/dirt,
/obj/machinery/computer/shuttle/caravan/trade1{
	dir = 8
	},
/obj/effect/turf_decal/tile/blue{
	dir = 1
	},
/obj/effect/turf_decal/tile/blue,
/obj/effect/turf_decal/tile/blue{
	dir = 8
	},
/turf/open/floor/iron/dark{
	initial_gas_mix = "TEMP=2.7"
	},
/area/shuttle/caravan/freighter1)
"PM" = (
/obj/machinery/light/small,
/obj/structure/bed,
/obj/item/bedsheet,
/obj/effect/decal/cleanable/dirt,
/obj/machinery/airalarm/all_access{
	dir = 8;
	pixel_x = 24
	},
/obj/machinery/button/door{
	id = "caravantrade1_cabin2";
	name = "Cabin Bolt Control";
	normaldoorcontrol = 1;
	pixel_x = -25;
	pixel_y = 6;
	specialfunctions = 4
	},
/obj/machinery/atmospherics/components/unary/vent_pump/on{
	dir = 1
	},
/obj/effect/turf_decal/tile/neutral{
	dir = 1
	},
/obj/effect/turf_decal/tile/neutral,
/obj/effect/turf_decal/tile/neutral{
	dir = 4
	},
/obj/effect/turf_decal/tile/neutral{
	dir = 8
	},
/turf/open/floor/iron/dark/airless,
/area/shuttle/caravan/freighter1)
"PS" = (
/obj/machinery/door/firedoor,
/obj/machinery/atmospherics/pipe/smart/manifold4w/supply/hidden,
/obj/structure/door_assembly/door_assembly_min{
	anchored = 1;
	density = 0;
	name = "broken airlock"
	},
/obj/effect/decal/cleanable/dirt,
/turf/open/floor/iron/airless,
/area/shuttle/caravan/freighter1)
"QY" = (
/obj/structure/table,
/obj/machinery/cell_charger,
/obj/machinery/firealarm{
	pixel_y = 24
	},
/obj/item/stack/cable_coil{
	pixel_x = 12;
	pixel_y = 4
	},
/turf/open/floor/iron/airless,
/area/shuttle/caravan/freighter1)
"RC" = (
/obj/effect/turf_decal/box/white/corners{
	dir = 1
	},
/obj/structure/closet/crate,
/obj/item/stack/sheet/mineral/uranium{
	amount = 10
	},
/obj/item/stack/sheet/mineral/uranium{
	amount = 10
	},
/obj/effect/decal/cleanable/dirt,
/turf/open/floor/iron/dark/airless,
/area/shuttle/caravan/freighter1)
"RN" = (
/obj/effect/turf_decal/bot,
/obj/machinery/space_heater,
/obj/effect/decal/cleanable/dirt,
/obj/machinery/atmospherics/components/unary/vent_pump/on{
	dir = 4
	},
/turf/open/floor/plating/airless{
	icon_state = "platingdmg3"
	},
/area/shuttle/caravan/freighter1)
"Sm" = (
/obj/machinery/atmospherics/pipe/smart/manifold4w/supply/hidden{
	dir = 4
	},
/mob/living/simple_animal/hostile/syndicate/ranged/smg/space,
/turf/open/floor/iron/airless,
/area/shuttle/caravan/freighter1)
"Su" = (
/obj/effect/decal/cleanable/dirt,
/turf/open/floor/iron/airless{
	icon_state = "damaged3"
	},
/area/shuttle/caravan/freighter1)
"Td" = (
/obj/structure/lattice,
/turf/template_noop,
/area/shuttle/caravan/freighter1)
"TE" = (
/obj/effect/decal/cleanable/dirt,
/obj/machinery/atmospherics/pipe/smart/manifold4w/supply/hidden,
/obj/machinery/meter,
/turf/open/floor/plating/airless,
/area/shuttle/caravan/freighter1)
"Ut" = (
/obj/effect/decal/cleanable/dirt,
/turf/open/floor/plating/airless,
/area/shuttle/caravan/freighter1)
"Uv" = (
/obj/effect/turf_decal/box/white/corners{
	dir = 4
	},
/turf/open/floor/iron/dark/airless,
/area/shuttle/caravan/freighter1)
"VD" = (
/obj/effect/mapping_helpers/airlock/cyclelink_helper,
/obj/effect/mapping_helpers/airlock/locked,
/obj/machinery/door/airlock/external{
	id_tag = "caravantrade1_bolt"
	},
/obj/docking_port/mobile{
	callTime = 250;
	dir = 2;
	dwidth = 5;
	height = 11;
	id = "caravantrade1";
	movement_force = list("KNOCKDOWN" = 0, "THROW" = 0);
	name = "Small Freighter";
	port_direction = 8;
	preferred_direction = 4;
	width = 21
	},
/turf/open/floor/plating,
/area/shuttle/caravan/freighter1)
"VO" = (
/obj/machinery/door/firedoor,
/obj/machinery/atmospherics/pipe/smart/manifold4w/supply/hidden{
	dir = 4
	},
/obj/machinery/door/airlock/engineering{
	name = "Engine Room"
	},
/turf/open/floor/plating/airless,
/area/shuttle/caravan/freighter1)
"Ws" = (
/obj/machinery/airalarm/all_access{
	dir = 8;
	pixel_x = 24
	},
/obj/machinery/atmospherics/pipe/smart/manifold4w/supply/hidden,
/turf/open/floor/plating/airless{
	icon_state = "platingdmg1"
	},
/area/shuttle/caravan/freighter1)
"WX" = (
/obj/effect/turf_decal/box/white/corners{
	dir = 8
	},
/obj/structure/closet/crate,
/obj/item/stack/sheet/plasteel/twenty,
/obj/item/stack/sheet/plasteel/twenty,
/turf/open/floor/iron/airless{
	icon_state = "damaged5"
	},
/area/shuttle/caravan/freighter1)
"WZ" = (
/obj/machinery/power/smes,
/obj/effect/turf_decal/stripes/line{
	dir = 4
	},
/obj/structure/cable,
/obj/effect/decal/cleanable/dirt,
/turf/open/floor/plating/airless,
/area/shuttle/caravan/freighter1)
"Xh" = (
/obj/machinery/door/poddoor{
	id = "caravantrade1_cargo";
	name = "Cargo Blast Door"
	},
/turf/open/floor/plating/airless,
/area/shuttle/caravan/freighter1)
"XI" = (
/obj/effect/turf_decal/bot_white,
/obj/structure/closet/emcloset,
/obj/effect/turf_decal/tile/neutral{
	dir = 1
	},
/obj/effect/turf_decal/tile/neutral,
/obj/effect/turf_decal/tile/neutral{
	dir = 4
	},
/obj/effect/turf_decal/tile/neutral{
	dir = 8
	},
/turf/open/floor/iron/dark/airless,
/area/shuttle/caravan/freighter1)
"Zk" = (
/obj/machinery/atmospherics/components/unary/vent_pump/on{
	dir = 1
	},
/obj/effect/turf_decal/tile/neutral{
	dir = 1
	},
/obj/effect/turf_decal/tile/neutral,
/obj/effect/turf_decal/tile/neutral{
	dir = 4
	},
/obj/effect/turf_decal/tile/neutral{
	dir = 8
	},
/turf/open/floor/iron/dark/airless,
/area/shuttle/caravan/freighter1)

(1,1,1) = {"
Jv
KX
vt
vt
vt
KC
Fv
Jv
Jv
Jv
Jv
"}
(2,1,1) = {"
Fv
mo
mo
mo
mo
mo
El
KX
vt
KC
Jv
"}
(3,1,1) = {"
El
RN
lC
WZ
lt
zd
El
mo
mo
mo
Fv
"}
(4,1,1) = {"
El
jr
bw
eX
Ws
TE
El
RC
cR
Ns
El
"}
(5,1,1) = {"
El
VO
El
El
El
VO
El
jS
Io
Er
El
"}
(6,1,1) = {"
El
hd
Kc
PM
El
nf
hy
Zk
uS
EZ
eP
"}
(7,1,1) = {"
LM
Jb
El
El
El
ss
dm
kO
uh
dg
NY
"}
(8,1,1) = {"
El
dx
GM
uA
Fv
sf
bn
Uv
uh
dq
Xh
"}
(9,1,1) = {"
El
kB
El
El
El
QY
Sm
Ax
yn
Su
eP
"}
(10,1,1) = {"
El
Dm
El
bR
El
ap
LC
lx
ey
WX
Xh
"}
(11,1,1) = {"
LM
yY
El
jg
El
El
dm
xz
Ov
Td
ur
"}
(12,1,1) = {"
LM
Ol
xm
Ke
EX
PS
aL
CR
Fx
fD
Eo
"}
(13,1,1) = {"
LM
gs
cX
EQ
bn
El
XI
Ut
Td
fD
fD
"}
(14,1,1) = {"
El
NL
bp
El
yO
El
El
zy
fD
fD
Jv
"}
(15,1,1) = {"
El
El
El
El
NE
LK
El
Jv
Jv
Jv
Jv
"}
(16,1,1) = {"
VD
lM
si
yC
mi
Ko
LM
Jv
Jv
Jv
Jv
"}
(17,1,1) = {"
Fv
El
El
El
eo
El
El
Jv
Jv
Jv
Jv
"}
(18,1,1) = {"
Jv
El
Ja
gR
CS
mw
El
Jv
Jv
Jv
Jv
"}
(19,1,1) = {"
Jv
LM
Od
EI
gw
EW
LM
Jv
Jv
Jv
Jv
"}
(20,1,1) = {"
Jv
LM
LM
mZ
Ow
LM
LM
Jv
Jv
Jv
Jv
"}
(21,1,1) = {"
Jv
Jv
LM
LM
LM
LM
Jv
Jv
Jv
Jv
Jv
"}
